Sezanm screenshot|Seznam screenshot-generator|
SimplePie|SimplePie|
Facebook external hit|facebookexternalhit|
Riddler|Riddler|
007ac9 Crawler|007ac9 Crawler|
360Spider|360Spider|
A6-Indexer|A6-Indexer|
ADmantX|ADmantX|
AHC|AHC|
AISearchBot|AISearchBot|
APIs-Google|APIs-Google|
Aboundex|Aboundex|
AddThis|AddThis|
Adidxbot|Adidxbot|
AdsBot-Google|AdsBot-Google|
AdsTxtCrawler|AdsTxtCrawler|
AdvBot|AdvBot|
Ahrefs|Ahrefs|
AlphaBot|AlphaBot|
Amazon CloudFront|Amazon CloudFront|
AndersPinkBot|AndersPinkBot|
Apache-HttpClient|Apache-HttpClient|
Apercite|Apercite|
AppEngine-Google|AppEngine-Google|
Applebot|Applebot|
ArchiveBot|ArchiveBot|
BDCbot|BDCbot|
BIGLOTRON|BIGLOTRON|
BLEXBot|BLEXBot|
BLP_bbot|BLP_bbot|
BTWebClient|BTWebClient|
BUbiNG|BUbiNG|
Baidu-YunGuanCe|Baidu-YunGuanCe|
Baiduspider|Baiduspider|
Barkrowler|Barkrowler|
BehloolBot|BehloolBot|
BingPreview|BingPreview|
BomboraBot|BomboraBot|
Bot.AraTurka.com|Bot.AraTurka.com|
BoxcarBot|BoxcarBot|
BrandVerity|BrandVerity|
Buck|Buck|
CC Metadata Scaper|CC Metadata Scaper|
CCBot|CCBot|
CapsuleChecker|CapsuleChecker|
Cliqzbot|Cliqzbot|
CloudFlare-AlwaysOnline|CloudFlare-AlwaysOnline|
Companybook-Crawler|Companybook-Crawler|
ContextAd Bot|ContextAd Bot|
CrunchBot|CrunchBot|
CrystalSemanticsBot|CrystalSemanticsBot|
CyberPatrol|CyberPatrol|
DareBoost|DareBoost|
Datafeedwatch|Datafeedwatch|
Daum|Daum|
DeuSu|DeuSu|
Diffbot|Diffbot|
Digg Deeper|Digg Deeper|
Digincore bot|Digincore bot|
Discordbot|Discordbot|
Disqus|Disqus|
DnyzBot|DnyzBot|
Domain Re-Animator Bot|Domain Re-Animator Bot|
DomainStatsBot|DomainStatsBot|
DuckDuckBot|DuckDuckBot|
DuckDuckGo-Favicons-Bot|DuckDuckGo-Favicons-Bot|
EZID|EZID|
Embedly|Embedly|
EveryoneSocialBot|EveryoneSocialBot|
ExtLinksBot|ExtLinksBot|
FAST Enterprise Crawler|FAST Enterprise Crawler|
FAST-WebCrawler|FAST-WebCrawler|
Facebot|Facebot|
Feedfetcher-Google|Feedfetcher-Google|
Feedly|Feedly|
Feedspotbot|Feedspotbot|
FemtosearchBot|FemtosearchBot|
Fetch|Fetch|
Fever|Fever|
Flamingo_SearchEngine|Flamingo_SearchEngine|
FlipboardProxy|FlipboardProxy|
Fyrebot|Fyrebot|
GarlikCrawler|GarlikCrawler|
Genieo|Genieo|
Gigablast|Gigablast|
Gigabot|Gigabot|
GingerCrawler|GingerCrawler|
Gluten Free Crawler|Gluten Free Crawler|
GnowitNewsbot|GnowitNewsbot|
Go-http-client|Go-http-client|
Google Web Preview|Google Web Preview|
Google-Adwords-Instant|Google-Adwords-Instant|
Gowikibot|Gowikibot|
GrapeshotCrawler|GrapeshotCrawler|
Grobbot|Grobbot|
HTTrack|HTTrack|
Hatena|Hatena|
IAS crawler|IAS crawler|
ICC-Crawler|ICC-Crawler|
IndeedBot|IndeedBot|
InterfaxScanBot|InterfaxScanBot|
IstellaBot|IstellaBot|
James BOT|James BOT|
Jamie's Spider|Jamie's Spider|
Jetslide|Jetslide|
Jetty|Jetty|
Jugendschutzprogramm-Crawler|Jugendschutzprogramm-Crawler|
K7MLWCBot|K7MLWCBot|
Kemvibot|Kemvibot|
KosmioBot|KosmioBot|
Landau-Media-Spider|Landau-Media-Spider|
Laserlikebot|Laserlikebot|
Leikibot|Leikibot|
Linguee Bot|Linguee Bot|
LinkArchiver|LinkArchiver|
LinkedInBot|LinkedInBot|
LivelapBot|LivelapBot|
Luminator-robots|Luminator-robots|
MJ12bot|MJ12bot|
Mail.RU_Bot|Mail.RU_Bot|
Mastodon|Mastodon|
MauiBot|MauiBot|
Mediapartners-Google|Mediapartners-Google|
Mediatoolkitbot|Mediatoolkitbot|
MegaIndex|MegaIndex|
MeltwaterNews|MeltwaterNews|
MetaJobBot|MetaJobBot|
MetaURI|MetaURI|
Miniflux|Miniflux|
MojeekBot|MojeekBot|
Moreover|Moreover|
MuckRack|MuckRack|
Multiviewbot|Multiviewbot|
NING|NING|
NerdByNature.Bot|NerdByNature.Bot|
NetcraftSurveyAgent|NetcraftSurveyAgent|
Netvibes|Netvibes|
Nimbostratus-Bot|Nimbostratus-Bot|
Nuzzel|Nuzzel|
Ocarinabot|Ocarinabot|
OpenHoseBot|OpenHoseBot|
OrangeBot|OrangeBot|
OutclicksBot|OutclicksBot|
PR-CY.RU|PR-CY.RU|
PaperLiBot|PaperLiBot|
Pcore-HTTP|Pcore-HTTP|
PhantomJS|PhantomJS|
PiplBot|PiplBot|
PocketParser|PocketParser|
Primalbot|Primalbot|
PrivacyAwareBot|PrivacyAwareBot|
Pulsepoint|Pulsepoint|
Python-urllib|Python-urllib|
Qwantify|Qwantify|
RankActiveLinkBot|RankActiveLinkBot|
RetrevoPageAnalyzer|RetrevoPageAnalyzer|
SBL-BOT|SBL-BOT|
SEMrushBot|SEMrushBot|
SEOkicks|SEOkicks|
SWIMGBot|SWIMGBot|
SafeDNSBot|SafeDNSBot|
SafeSearch microdata crawler|SafeSearch microdata crawler|
ScoutJet|ScoutJet|
Scrapy|Scrapy|
Screaming Frog SEO Spider|Screaming Frog SEO Spider|
SemanticScholarBot|SemanticScholarBot|
SimpleCrawler|SimpleCrawler|
Siteimprove.com|Siteimprove.com|
SkypeUriPreview|SkypeUriPreview|
Slack-ImgProxy|Slack-ImgProxy|
Slackbot|Slackbot|
Snacktory|Snacktory|
SocialRankIOBot|SocialRankIOBot|
Sogou|Sogou|
Sonic|Sonic|
StorygizeBot|StorygizeBot|
SurveyBot|SurveyBot|
Sysomos|Sysomos|
TangibleeBot|TangibleeBot|
TelegramBot|TelegramBot|
Teoma|Teoma|
Thinklab|Thinklab|
TinEye|TinEye|
ToutiaoSpider|ToutiaoSpider|
Traackr.com|Traackr.com|
Trove|Trove|
TweetmemeBot|TweetmemeBot|
Twitterbot|Twitterbot|
Twurly|Twurly|
Upflow|Upflow|
UptimeRobot|UptimeRobot|
UsineNouvelleCrawler|UsineNouvelleCrawler|
Veoozbot|Veoozbot|
WeSEE:Search|WeSEE:Search|
WhatsApp|WhatsApp|
Xenu Link Sleuth|Xenu Link Sleuth|
Y!J|Y!J|
YaK|YaK|
Yahoo Link Preview|Yahoo Link Preview|
YandexBot|YandexBot|
Yeti|Yeti|
YisouSpider|YisouSpider|
Zabbix|Zabbix|
ZoominfoBot|ZoominfoBot|
ZumBot|ZumBot|
ZuperlistBot|ZuperlistBot|
^LCC|^LCC|
acapbot|acapbot|
acoonbot|acoonbot|
adbeat_bot|adbeat_bot|
adscanner|adscanner|
aiHitBot|aiHitBot|
antibot|antibot|
arabot|arabot|
archive.org_bot|archive.org_bot|
axios|axios|
backlinkcrawler|backlinkcrawler|
betaBot|betaBot|
bibnum.bnf|bibnum.bnf|
bingbot|bingbot|
binlar|binlar|
bitlybot|bitlybot|
blekkobot|blekkobot|
blogmuraBot|blogmuraBot|
bnf.fr_bot|bnf.fr_bot|
bot-pge.chlooe.com|bot-pge.chlooe.com|
botify|botify|
brainobot|brainobot|
buzzbot|buzzbot|
cXensebot|cXensebot|
careerbot|careerbot|
centurybot9|centurybot9|
changedetection|changedetection|
check_http|check_http|
citeseerxbot|citeseerxbot|
coccoc|coccoc|
collection@infegy.com|collection@infegy.com|
content crawler spider|content crawler spider|
contxbot|contxbot|
convera|convera|
crawler4j|crawler4j|
curl|curl|
datagnionbot|datagnionbot|
dcrawl|dcrawl|
deadlinkchecker|deadlinkchecker|
discobot|discobot|
domaincrawler|domaincrawler|
dotbot|dotbot|
drupact|drupact|
ec2linkfinder|ec2linkfinder|
edisterbot|edisterbot|
electricmonk|electricmonk|
elisabot|elisabot|
epicbot|epicbot|
eright|eright|
europarchive.org|europarchive.org|
exabot|exabot|
ezooms|ezooms|
facebookexternalhit|facebookexternalhit|
filterdb.iss.net|filterdb.iss.net|
findlink|findlink|
findthatfile|findthatfile|
findxbot|findxbot|
fluffy|fluffy|
fr-crawler|fr-crawler|
fuelbot|fuelbot|
g00g1e.net|g00g1e.net|
g2reader-bot|g2reader-bot|
gnam gnam spider|gnam gnam spider|
google-xrawler|google-xrawler|
grub.org|grub.org|
gslfbot|gslfbot|
heritrix|heritrix|
http_get|http_get|
httpunit|httpunit|
ia_archiver|ia_archiver|
ichiro|ichiro|
imrbot|imrbot|
integromedb|integromedb|
intelium_bot|intelium_bot|
ip-web-crawler.com|ip-web-crawler.com|
ips-agent|ips-agent|
iskanie|iskanie|
it2media-domain-crawler|it2media-domain-crawler|
jyxobot|jyxobot|
lb-spider|lb-spider|
libwww|libwww|
linkapediabot|linkapediabot|
linkdex|linkdex|
lipperhey|lipperhey|
lssbot|lssbot|
lssrocketcrawler|lssrocketcrawler|
ltx71|ltx71|
magpie-crawler|magpie-crawler|
mappydata|mappydata|
memorybot|memorybot|
mindUpBot|mindUpBot|
mlbot|mlbot|
moatbot|moatbot|
msnbot|msnbot|
msrbot|msrbot|
nerdybot|nerdybot|
netEstate NE Crawler|netEstate NE Crawler|
netresearchserver|netresearchserver|
newsharecounts|newsharecounts|
newspaper|newspaper|
niki-bot|niki-bot|
nutch|nutch|
okhttp|okhttp|
omgili|omgili|
openindexspider|openindexspider|
page2rss|page2rss|
panscient|panscient|
phpcrawl|phpcrawl|
pingdom|pingdom|
pinterest|pinterest|
postrank|postrank|
proximic|proximic|
psbot|psbot|
purebot|purebot|
python-requests|python-requests|
redditbot|redditbot|
rogerbot|rogerbot|
scribdbot|scribdbot|
seekbot|seekbot|
semanticbot|semanticbot|
sentry|sentry|
seoscanners|seoscanners|
seznambot|seznambot|
sistrix crawler|sistrix crawler|
sitebot|sitebot|
siteexplorer.info|siteexplorer.info|
smtbot|smtbot|
spbot|spbot|
speedy|speedy|
summify|summify|
tagoobot|tagoobot|
toplistbot|toplistbot|
tracemyfile|tracemyfile|
trendictionbot|trendictionbot|
turnitinbot|turnitinbot|
twengabot|twengabot|
um-LN|um-LN|
urlappendbot|urlappendbot|
vebidoobot|vebidoobot|
vkShare|vkShare|
voilabot|voilabot|
wbsearchbot|wbsearchbot|
web-archive-net.com.bot|web-archive-net.com.bot|
webcompanycrawler|webcompanycrawler|
webmon|webmon|
wget|wget|
wocbot|wocbot|
woobot|woobot|
woriobot|woriobot|
wotbox|wotbox|
xovibot|xovibot|
yacybot|yacybot|
yandex.com|yandex.com|
yanga|yanga|
yoozBot|yoozBot|
zgrab|zgrab
